Ngay,Luot_xem,So_luot_xem_trung_binh,Thoi_gian_xem_trung_binh,Ti_le_thoat_trang,Luot_truy_cap,So_khach_truy_cap_moi,So_khach_truy_cap_hien_tai
01/12/2022,7146,3.16,00:01:06,0.2679,2262,1290,972
02/12/2022,6667,3.3,00:01:08,0.2563,2021,1186,835
03/12/2022,6591,3.32,00:01:06,0.2555,1988,1160,828
04/12/2022,7492,3.34,00:01:07,0.234,2244,1402,842
05/12/2022,6988,3.24,00:01:08,0.2469,2155,1334,821
06/12/2022,7626,3.21,00:01:05,0.2532,2378,1529,849
07/12/2022,7836,3.34,00:01:09,0.239,2343,1514,829
08/12/2022,7282,3.21,00:01:07,0.2481,2269,1472,797
09/12/2022,6393,3.04,00:01:06,0.2507,2102,1385,717
10/12/2022,6900,3.26,00:01:08,0.2734,2114,1410,704
11/12/2022,7984,3.18,00:01:08,0.2579,2513,1659,854
12/12/2022,12741,3.38,00:01:10,0.2321,3775,2547,1228
13/12/2022,8873,3.15,00:01:08,0.272,2820,1986,834
14/12/2022,8528,3.23,00:01:10,0.2394,2644,1888,756
15/12/2022,8368,3.12,00:01:08,0.218,2679,1927,752
16/12/2022,8125,3.16,00:01:06,0.2461,2572,1833,739
17/12/2022,8493,3.31,00:01:07,0.2589,2565,1807,758
18/12/2022,7733,3.07,00:01:05,0.246,2516,1893,623
19/12/2022,8184,3.25,00:01:08,0.2427,2518,1819,699
20/12/2022,8266,3.43,00:01:10,0.2527,2410,1746,664
21/12/2022,8475,3.4,00:01:06,0.2538,2494,1766,728
22/12/2022,7364,3.19,00:01:07,0.2392,2308,1608,700
23/12/2022,5439,2.93,00:01:03,0.2256,1857,1352,505
24/12/2022,5803,3.51,00:01:10,0.2429,1655,1183,472
25/12/2022,7292,3.19,00:01:07,0.2179,2285,1589,696
26/12/2022,7302,3.12,00:01:05,0.2429,2343,1677,666
27/12/2022,6158,3.04,00:01:01,0.2255,2027,1508,519
28/12/2022,6066,3.04,00:01:04,0.2436,1995,1418,577
29/12/2022,5104,2.77,00:00:58,0.252,1841,1353,488
30/12/2022,5055,2.79,00:01:01,0.2394,1813,1320,493
31/12/2022,5287,2.82,00:01:04,0.2648,1877,1410,467
01/1/2023,6423,3.18,00:01:11,0.2262,2020,1080,940
02/1/2023,6179,2.82,00:01:02,0.2439,2189,1289,900
03/1/2023,6292,3.05,00:01:04,0.2041,2063,1229,834
04/1/2023,5861,2.86,00:01:02,0.2424,2046,1216,830
05/1/2023,7028,3.19,00:01:07,0.2093,2203,1314,889
06/1/2023,5696,3.04,00:01:05,0.23,1874,1143,731
07/1/2023,5859,2.9,00:01:03,0.2458,2022,1217,805
08/1/2023,7113,3.32,00:01:05,0.2147,2143,1377,766
09/1/2023,5926,3.06,00:01:03,0.2297,1937,1277,660
10/1/2023,7228,3.38,00:01:10,0.2374,2140,1329,811
11/1/2023,6137,2.88,00:01:06,0.2514,2132,1420,712
12/1/2023,6064,3.14,00:01:05,0.2205,1932,1248,684
13/1/2023,3299,2.96,00:01:04,0.2159,1116,756,360
14/1/2023,422,2.13,00:01:04,0.2071,198,114,84
15/1/2023,298,2.21,00:00:44,0.2815,135,80,55
16/1/2023,357,2.1,00:00:47,0.1882,170,108,62
17/1/2023,107,1.75,00:00:43,0.3443,61,38,23
18/1/2023,60,2,00:00:35,0.3,30,15,15
19/1/2023,67,1.63,00:00:44,0.3415,41,25,16
20/1/2023,56,1.75,00:01:07,0.25,32,20,12
21/1/2023,14,1.17,00:00:12,0.4167,12,6,6
22/1/2023,40,2,00:00:40,0.4,20,4,16
23/1/2023,42,2.1,00:01:22,0.3,20,6,14
24/1/2023,25,1.14,00:00:33,0.5,22,6,16
25/1/2023,51,1.96,00:00:32,0.4615,26,8,18
26/1/2023,55,1.72,00:00:59,0.375,32,12,20
27/1/2023,33,1.27,00:00:42,0.3846,26,9,17
28/1/2023,99,1.65,00:00:41,0.35,60,26,34
29/1/2023,74,1.8,00:00:57,0.4146,41,19,22
30/1/2023,6524,2.9,00:01:07,0.2358,2252,1645,607
31/1/2023,5946,2.95,00:01:06,0.253,2016,1467,549
01/2/2023,6051,2.92,00:01:08,0.228,2070,1342,728
02/2/2023,7432,3.2,00:01:10,0.2193,2326,1626,700
03/2/2023,6010,2.98,00:01:06,0.2321,2016,1382,634
04/2/2023,6158,3.1,00:01:09,0.2409,1984,1365,619
05/2/2023,5759,2.97,00:01:07,0.2169,1936,1383,553
06/2/2023,5346,3.06,00:01:07,0.2213,1749,1285,464
07/2/2023,5264,2.98,00:01:04,0.2329,1765,1265,500
08/2/2023,5375,3.02,00:01:07,0.248,1778,1283,495
09/2/2023,5758,2.97,00:01:08,0.2229,1938,1414,524
10/2/2023,5870,2.88,00:01:08,0.2423,2039,1571,468
11/2/2023,5583,2.94,00:01:05,0.2215,1896,1392,504
12/2/2023,5644,3.02,00:01:05,0.2127,1871,1415,456
13/2/2023,6473,2.88,00:01:08,0.2243,2247,1706,541
14/2/2023,5763,3.14,00:01:08,0.254,1835,1362,473
15/2/2023,6460,3.09,00:01:10,0.2216,2089,1584,505
16/2/2023,6347,3.12,00:01:11,0.2158,2034,1545,489
17/2/2023,6009,2.85,00:01:06,0.2454,2111,1617,494
18/2/2023,5500,2.85,00:01:02,0.2173,1928,1449,479
19/2/2023,6403,2.96,00:01:06,0.2102,2160,1673,487
20/2/2023,6479,3.03,00:01:07,0.2237,2137,1640,497
21/2/2023,6022,3.01,00:01:06,0.2063,2002,1597,405
22/2/2023,6053,3.1,00:01:06,0.1969,1955,1516,439
23/2/2023,5700,2.66,00:01:01,0.2061,2140,1679,461
24/2/2023,6546,2.59,00:01:04,0.247,2526,1996,530
25/2/2023,6540,2.73,00:01:07,0.2278,2397,1917,480
26/2/2023,6786,2.55,00:01:00,0.2541,2656,2119,537
27/2/2023,7215,2.75,00:01:01,0.2323,2622,2114,508
28/2/2023,7367,2.78,00:01:05,0.2376,2651,2131,520
